    R      1920 1080

NO      ../images/Lugia.png.xpm 


    SO ../images/Lugia.png.xpm  

WE ../images/Lugia.png.xpm 

EA ../images/Lugia.png.xpm  

S ../images/Lugia.png.xpm 



F 93,245,56

C 30,115,250




111111111111111111111111111111111
100000000000000000000000000000001
100100100010001000010000010001001
100100100010001000000001000000001
100100100010001010000000000100001
100100100010001000010000001000001
10010010001000101010000N000000001
100100100010001000000000001000001
100100100010001000100001000010001
100100100010001000010000000000001
100100100010001000000000000000001
100100100010001000000010001000001
100100100010001000000000000000001
111111111111111111111111111111111