R      1000 700

NO ./images/poketext.xpm


    SO ./images/marionfab.xpm

WE ./images/pokecenter.xpm

EA ./images/pokecenter.xpm

S ./images/rayquaza.xpm
S1 ./images/pokeball.xpm
S2 ./images/ronflex.xpm
S3 ./images/pokeflute.xpm
S4 ./images/tower.xpm
S5 ./images/lugia.xpm

F 8,196,64

C 30,115,250


111111111111111111111111111111111
100000000100000000000100001000501
100000000000000000000131000100001
100000000100000000000010100100001
100030000100000000000001101000001
111111111100000000000000101000001     111111111111
100000000000000000000000000000001    100000000000011
10000000000000000000000000000000111111000000000000001
10000000000000011110000000000006160000000000000000701
10000000000011100001100000000000111111000000000000001
100000000001000020000100000000001    100000000000011
100000000110000000000011000000001     111111111111
100000000100000000000001000000001
100000000010000000000010000000001
100000000001000000000100000000001
100000000000111101111000000000001
100000000000000040000000000000001
100000000000000000000000000000001
10000000000000000N000000000000001
111111111111111111111111111111111