R      1000 700

NO ./images/poketext.xpm


    SO ./images/pokecenter.xpm

WE ./images/kyogre.xpm

EA ./images/poketext.xpm

S ./images/rayquaza.xpm



F 8,196,64

C 30,115,250


111111111111111111111111111111111
100000000100000000000100001000001
100000000000000000000101000100001
100000000100000000000010100100001
100000000100000000000001101000001
111111111100000000000000101000001
100000000000000000000000000000011
100000000000000000000000000000011
100000000000000111100000000000011
100000000000111000011000000000011
100000000001000020000100000000011
100000000110000000000011000000011
100000000100000000200001000000011
100000000010000000000010000000011
100000000001000000000100000000011
100000000000111101111000000000011
100000000000000000000000000000011
100000000000000000000000000000011
10000000000000000N000000000000011
111111111111111111111111111111111