    R      1000  800

NO      ../images/Lugia.png.xpm 


    SO ../images/Lugia.png.xpm  

WE ../images/Lugia.png.xpm 

EA ../images/Lugia.png.xpm  

S ../images/Lugia.png.xpm 



F 220,100,0

C 225,30,0




11111111111111111111
10000000000000000001
10000000000000000001
10000000000000000001
10000010000000000001
10000000010000100001
10000010000000000001
10000000000000000001
10000000000010000001
10001000000000000001
10000000000N00000001
10000001000000000001
10000000000000000001
10000000010000000001
10000000000000100001
11111111111111111111