    R      1920    1080

NO      ./path_to_the_north_texture.xpm 


    SO ./path_to_the_south_texture.xpm 

WE ./path_to_the_west_texture.xpm

EA ./path_to_the_east_texture.xpm 

S ./path_to_the_sprite_texture.xpm



F 220,100,0

C 225,30,0




111111111111111111111111
100000000000000000000001
100020200000000002020001
100022200000000002220001
100000000000000000000001
100000002020200000000001
100000000202000000000001
100000000000000000000001
10000000000N000000000001
111111111111111111111111