    R      1000 600

NO      ./images/tower.xpm 


    SO ./images/tower.xpm  

WE ./images/tower.xpm 

EA ./images/tower.xpm  

S ./images/tower.xpm 



F 220,100,0

C 225,30,0



11111111111111111111111111
10000000000000000000000011
10000000000000000000010011
10000000000000000000100011
10000000000000001000001011
10000000000000000000100011
100000000000N0000100000011
10000000000000000000100011
10000000000000000000000011
10000000000000010000100011
10000000000000000000000011
11111111111111111111111111
