

NO      ./images/poketext.xpm

    SO ./images/pokecenter.xpm

WE ./images/lugia.xpm

EA ./images/lugia.xpm

S ./images/lugia.xpm



F 8,196,64

C 30,115,245

1111111
1002001
1000001
100N001
1111111

